NO textures/tile_wall.png
SO textures/tile_wall.png
WE textures/tile_wall.png
EA textures/tile_wall.png
DR textures/metal_door.png
FL textures/floor.png
CL textures/floor.png


F 220,100,0
C 225,0,0

    
        1111111111111111111111111
        1000000000110000000000001
        1011000001110000000000001
        1001000000000000000000001
111111111011000001110000000000001
100000000011000001110111111111111
11110111111111011100000010001   1
11110111111111011101010010001
11000000110101011100000010001
10000000000000001100000020001
10000000000000001101010010001
11000001110101011111011110N0111
11110111 1110101 101111020001
11111111 1111111 111111111111
