NO                 textures/checker.png





          SO           textures/checker.png




WE              textures/checker.png






      EA        textures/checker.png

    F 220,100,0






   C 225,30,0

11111111
10000101
100S0001
10000001
10000001
10000001
1000*001
11111111
