NO textures/tile_wall.png
SO textures/tile_wall.png
WE textures/tile_wall.png
EA textures/tile_wall.png

F 220,100,0
C 225,30,0

11111111111111111111111111111
10000000000010001000000000001
10000000000010001000000000001
10000000000010001000000000001
11111111111110001111111111111
10000000000000000000000000001
10000000000000N00000000000001
10000000000000000000000000001
11111111111110001111111111111
10000000000010001000000000001
10000000000010001000000000001
10000000000010001000000000001
11111111111111111111111111111