NO textures/tile_wall.png
SO textures/tile_wall.png
WE textures/tile_wall.png
EA textures/tile_wall.png
DR textures/metal_door.png
CL textures/floor.png
FL textures/floor.png


F 220,100,0
C 225,0,0
 
        1111111111111111111111111
        1000000000110000000000001
        1011000001110000000000001
        1001000000200000000000001
111111111011000001110000000000001
100000000011000001112111111111111
11112111111111011100000010*01   1
11110111111111011101010010001
11000000110101011100000010001
10000000000000001100000020001
10000000000000001101010010001
11000001110121211111011110N0111
11110111 1110101 101111000001
11111111 1111111 111111111111