NO textures/tile_wall.png
SO textures/tile_wall.png
WE textures/tile_wall.png
EA textures/tile_wall.png
FL textures/floor.png
CL textures/floor.png

F 220,100,0
C 225,30,0

    
11111111111111111111111111111111111111111111111
1*00000000000000000000*0000000000000000000000*1
10101010101010101010101010101010101010101010101
10000000000000000000000000000000000000000000001
1010101010101*101010101010101010101010101010101
10000000000000000000000000000000000000000000001
10101010101010101010101010101010101010101010101
100000000000000000000000000*0000000000000000001
10101010101010101010101010101010101010101010101
10000000000000000000000000000000000000000000001
101010101010101*1010101010101010101010101010101
10000000000000000000000000000*00000000000000001
10101010101010101010101010101010101010101010101
100000000000000*000000000000000000000000*000001
10101010101010101010101010101010101010101010101
10000000000000000000000000000000000000000000001
10101010101010101010101010101010101010101010101
1*0000000000000000000000000N00000000000000000*1
11111111111111111111111111111111111111111111111