NO textures/tile_wall.png
SO textures/tile_wall.png
WE textures/tile_wall.png
EA textures/tile_wall.png
FL textures/floor.png
CL textures/floor.png

F 220,100,0
C 225,30,0

    
1111111111111111111111111111111111111111111111
1W000000***00000000000000000000000000000000001
1000000000000000000000000000000000000000000001
1111111111111111111111111111111111111111111111