NO                 textures/checker.png





          SO           textures/checker.png




WE              textures/checker.png






      EA        textures/checker.png

    F 220,100,0






   C 225,30,0

11111111
1N1    1
1      1
111    1
101      1
111
111111111
