NO textures/tile_wall.png
SO textures/tile_wall.png
WE textures/tile_wall.png
EA textures/tile_wall.png
FL textures/floor.png
CL textures/floor.png

F 220,100,0
C 225,30,0

    
1111111111111111111111111111111111111111111111
1********************************************1
1********************************************1
1000000000000000000000000000000000000000000001
1000000000000000000000000000000000000000000001
1000000000000000000000000000000000000000000001
1000000000000000000000000000000000000000000001
100000000000000*000000000000000000*00000000001
1000000000000000000000000000000000000000000001
1000000000000000000000000000000000000000000001
10000000000000000000*0000000000000000000000001
1*0000000000000000000000000N0000000000000000*1
1111111111111111111111111111111111111111111111