NO textures/sci-fi/north.png
SO textures/sci-fi/south.png
WE textures/sci-fi/west.png
EA textures/sci-fi/east.png
DR textures/sci-fi/door.png
CL textures/sci-fi/ceiling.png
FL textures/sci-fi/floor.png


F 220,100,0
C 225,0,0
 
        1111111111111111111111111
        1000000000110000000000001
        1011000*011100000000*0001
        1001000000000000000000001
111111111011000001110000000000001
100000000*11000001110111111111111
11112111111111011100000010*01   1
1111*111111111011101010010001
110000001101*101110*000010001
10000000000000001100000020001
10**0000000000001101010010001
11000001110101011111011110N0111
11110111 111*101 101111020001
11111111 1111111 111111111111