NO textures/tile_wall.png
SO textures/tile_wall.png
WE textures/tile_wall.png
EA textures/tile_wall.png

F 220,100,0
C 225,30,0

    
1111111111111111111111111111111111111111111111111111111111111111111111
1010101010101010101010110101010101010101011010101010101010101010110101
1000000000000000000000000000000000000000000000000000000000000000000001
100000000000000000000000000000000000000N000000000000000000000000000001
1111111111111111111111111111111111111111111111111111111111111111111111